measures number: 100
56
8000048
16000048
24000048
32000048
40000048
48000048
56000048
64000048
72000048
80000048
88000048
96000048
104000048
112000048
120000048
128000048
136000048
144000048
152000048
160000048
168000048
176000048
184000048
192000048
200000048
208000048
216000048
224000048
232000048
240000048
248000048
256000048
264000048
272000048
280000048
288000048
296000048
304000048
312000048
320000048
328000048
336000048
344000048
352000048
360000048
368000048
376000048
384000048
392000048
400000048
408000048
416000048
424000048
432000048
440000048
448000048
456000048
464000048
472000048
480000048
488000048
496000048
504000048
512000048
520000048
528000048
536000048
544000048
552000048
560000048
568000048
576000048
584000048
592000048
600000048
608000048
616000048
624000048
632000048
640000048
648000048
656000048
664000048
672000048
680000048
688000048
696000048
704000048
712000048
720000048
728000048
736000048
744000048
752000048
760000048
768000048
776000048
784000048
792000048
